000000000000000000000
0ddddddddddddddddddd0
0d0000000b000000000d0
0d0000000b000000000d0
0d0000000b000000000d0
0d0000ddddddddd0000d0
0d0000d0000000d0000d0
0d0000d0000000d0000d0
0d0000d0000000d0000d0
0d0000d0000000d0000d0
0daaaad0000000dccccd0
0d0000d0000000d0000d0
0d0000d0000000d0000d0
0d0000d0000000d0000d0
0d0000ddddddddd0000d0
0d0000000e000000000d0
0d0000000e000000000d0
0d0000000e000000000d0
0ddddddddddddddddddd0
000000000000000000000